1111111111111
10010000000C1
1110011111001
1P1011E100001
1111111111111