1111111111111
10010000001C1
1110011111111
1P1011E100001
1111111111111