1111111111111
10010000000C1
1000011001
1P0011E000001
1111111111111