1111111111111
10010C00000C1
1000100000001
1P1000E00C001
1111111111111