1111111111111
11010C00000C1
1000100000001
1CP000E0000C1
11010C00000C1
11010C00000C1
11010C00000C1
11010C00000C1
11010C00000C1
11010C00000C1
11010C00000C1
1111111111111