11111111111111111111
1C010C00000C100000C1
10001000000000000001
1CP000E0000C10000001
11010C00000C10000001
11010C00000C10000001
11010C00000C10000001
11010C00000C10000001
11010C00000C1000C001
11010C00000C10000001
1C010C00000C100000C1
11111111111111111111