1111111111111
10C00000000C1
1001011111101
1P1011E000001
1111111111111