1111111111111
10C00000001C1
1010011111101
1P1011E000001
1111111111111